####################################
|                                  |
|                                  |
|                                  |
################                   |
|                                  |
|                                  |
|                                  |
|                #            #    |
|                #            #    |
|                #            #    |
|                #            #    |
|                ||||||||||||||    |
|                                  |
|                           ########
|                                  |
|                                  |
####################################
      
                         
